NO test/aaa.xpm
SO test/hy.xpm
F           0,200,0
EA test/hell.xpm
WE test/wood.xpm

C 150,100,255

11111111111111111111111111111
10000000000000000000000000001
10000000000000000000000000001
10000000000000000000000000001
10000000000000000000000000001
10000000000001000000000000001
10000000000010010000000000001
10000000000011110000000000001
10000000000100000000000000001
10000000000100000000000000001
1000000000010000S000000000001
10000000000100000000000000001
11111111111111111111111111111