NO test/vivi.xpm
SO test/vivi.xpm
F           233,233,233
EA test/vivi.xpm
WE test/vivi.xpm

C 100,100,100



11111111111111111111
1000000000000000W001
11D1111111C11111C111
10000010000001000001
100000C0000001000001
11111110000011000001
      10000111000001
      10001111000001
      11011111000001
      11111111000001
             1000001
             1000001
             1000001
             1111111
