NO test/wat.xpm
SO test/hy.xpm
F           233,233,233
EA test/rrrr.xpm
WE test/hehe.xpm

C 100,100,100


111111111
1000000001
100000000111111
100000000100001
100000000100E01
100010000111111
1000000001
1000000001
1000000001
1111111111