NO test/Wattaaa.xpm
SO test/stg.xpm
F           0,255,0
EA test/hell.xpm
WE test/hmmmm.xpm

C 0,0,0


1111111111
10000N0001
100000000111111
100000000100001
100000000100001
100010000111111
1000000001
1000000001
1000000001
1111111111
