NO test/wat.xpm
SO test/me.xpm
F           0,0000000255,1                                     
EA test/rrrr.xpm
WE test/hehe.xpm

C 40,02,100                                     


1111111111111111
1000000000000001
1000000010000001
1000000000000001
1E11011000000001
1000011000000001
111111000000001
10000000011111
111111111