NO test/tach.xpm
SO test/tach.xpm
F           0,0000000255,1                                     
EA test/tach.xpm
WE test/tach.xpm

C 4,02,10                                      


111111
1000001
1000001
1000001
1S11011
1000011
111111
