NO test/wat.xpm
SO test/hy.xpm
F           233,233,233
EA test/rrrr.xpm
WE test/hehe.xpm

C 100,100,100


1111111111
10000N0001
1000000001
1000000001
1000000001
1000100001
1000000001
1000000001
1000000001
1111111111