NO test/tach.png
SO test/tach.png
F           0,0000000255,1                                     
EA test/tach.png
WE test/tach.png

C 4,02,10                                      


  111
  1111111111111111111111111
  1000000000000S00000000111
  1111111111111000000000111
  1111111111111000000000111
  1111111110000000000000111
  1111111100000000000000111
  1111111111100000000000111
  1111111111111111111111111
