NO test/Wattaaa.xpm
SO test/aaa.xpm
F           0,200,0
EA test/hell.xpm
WE test/hmmmm.xpm

C 150,100,255


11111111111
1000000001
10000S000111111
1000D0000D0000C1
100000000100001
1000D0000111111
1000000001
1000000001
100000C001
1111111111
