NO test/tach.xpm
SO test/tach.xpm
F           0,0000000255,1                                     
EA test/tach.xpm
WE test/tach.xpm

C 4,02,10                                      


111111
100001
1S1011
100011
111111
